000000000000000000000000000000000000000000000000000000000000000000000000000000000000000000000000000000000000000000000000000000000000000000
000000000000000000000000000000000000000000000000000000000000000000000000000000000000000000000000000000000000000000000000000000000000000000
000000000000000000000000000000000000000000000000000000000000000000000000000000000000000000000000000000000000000000000000000000000000000000
00000005422.........................111000000000000000000000000000000000000000000000000000000000000111............000000000000000000000000
00000000022.........00000000.........111300000000000000000000000000000000000000000000000000000000011.................000000000000000000000
00000000000000011100000000.......0000000000000000000000000000000000000000000000000000000000000006...........0000..................50000000
000000000000000000000002.......00000000000000000000000000001.............000000000000000000000000.......0000...............000.....0000000
000000000000000000000022........6..0000000000000000.....11111................0000000000000000000000222000000.....0000.............00000000
0000000000000000000000322..............00000000..........1000000000000..........300000000000000000222000000000......0000......000000000000
00000000000000000000000000...............0000......00000000000000000000........4344000000000000534222000000000000......0000...000000000000
...00000000000000000000000000000000000.............0000000000....22220000.....34500000000000000003222200000000000.......000022220000000000
..@..00000000000000000000000000000.....................0000.......2200000000000000000000000000002222....00000000.........00003330000000000
00..........0000000000000000........000000000000.............0000000000000000000000000000000000........000000001.........00000000000000000
000000..........................000000000000000000000000..........6..00000000000000000000000002.......0000000041.............0000000000000
00000000................6000000000000.6..00000000000000000000.............000000000000000000002......000000000000.............000000000000
000000....0000000000000000000000011..........00000000000000000000............000000000000000032.......000000000000.............00000000000
000322....0000000000000000000000311.............................................000000000000022........0000000000000000........60000000000
00022.....0000000000022000000000000.......00000000....................0000.........000000000000..............000000000000......00000000000
0002......00000000000222000000000000....000000000000000000000000..........0000.........000000000000............00000000000.........0000000
000.......0000000000....0000000000000.....0000..6..000000000000000000.....110000........000000000000000..........00000000000.......0000000
000.....00000000000....00000000000000000............220000000000000000.....110000........0000000000000000........0000000000000022220000000
000...0000000000......0000000000000000000..............22000000000000........1140000.....0000000000000000........0000000000000000222000000
000.....000000...............0000000000.............22000000000000............110000.....0000000000000000..........00000000000222220000000
0006..................000..........00.........6...22000000000000............11100000000........00000000.......00...00000000000022220000000
000..............00000000000...........00000000000000000000...............110000000000000...................0000....00000000.......0000000
000001111..000000000000000000000........000000000000000...................000000000000000000000000...6...00000000................000000000
000000041000000000000000000000000000............................6......000000000000000000000000000000000000000000000...........00000000000
000000000000000000000000000000000000000000000000000000000000000000000000000000000000000000000000000000000000000000000000000000000000000000
000000000000000000000000000000000000000000000000000000000000000000000000000000000000000000000000000000000000000000000000000000000000000000
000000000000000000000000000000000000000000000000000000000000000000000000000000000000000000000000000000000000000000000000000000000000000000

win_count = 300